6666666666666666666666666666666
6000000000000000000000000000006
6000002222200000000000005555006
6000002000200000000000005005006
6000002000200003030300000000006
6000002000200000000000055005506
6000002202200003000300005005006
6000000000000000000000000000006
6000000000000003030300000000006
6000000000000000000000000000006
6077777700000000000000000111116
6070000000000000000000000100016
6070000000000000000000000000016
6070000000000000000000000100016
6077777700000000000000000111116
6000000000000000000000000000006
6444444440000000000000000000006
6404000040000000000008880000006
6400007040000000000000080000006
6404000040000000000000088888886
6404444440000000000000000000036
6400000000000000000000088888886
6444444440000000000008880000006
6666666666666666666666666666666

