444444444444444477777777
400000000000000070000007
401000000000000000000007
402000000000000000000007
403000000000000070000007
404000055555555577077777
405000050505050570007771
406000050000000570000007
407000000000000000007771
407000050000000570000007
400000050000000570007771
400000055550555577777771
666666666660666666666666
700000000000000000000004
666666066660666666666666
444444044460622222223333
400000000460620000020002
400000000000620050020002
400000000460620000022022
406060000460000050000002
400500000460620000022022
406060000460620050020002
400000000460620000020002
444444444411122222233333


