666666666664464464644464
600000000064000000000004
603300000664000000000006
600300000000000000000006
603300000664000000000004
600000000064000006660646
666606666664444446000006
777707777060606064040606
770000007606060666000006
700000000000000066000004
700000000000000066060606
770000007606060666460666
777707777664066463330333
222202222464006063000003
220000022400000043000003
200000002400000043000003
100000001444446063300033
200000002221222660050505
220000022200022050500055
200000002000002505050505
100000000000000000000005
200000002000002505050505
220000022200022050500055
222212222221222555555555



